ABABSA	Inas	1
ABBAD	Mohamed Nazim	1
ABDELAZIZ	Achraf Djassem	1
ABDELBAKI	Ines	1
ABDELLI	Nadjib	1
ABDOUN	Lilia Asma	1
ABERKANE	Meriem	1
ADJOU	Anis	1
AFIA	Mustapha Ibrahim	1
AGGOUNE	Abderrahmane Ryad	1
AGOULMINE	Sofiane	1
AISSANI	Yasmine	1
AIT ABDELKRIM	Daya	1
AIT AHMED	Racim	1
AIT BALI	Tassadit	1
AIT YAHIATENE	Lydia	1
AKNINE	Sabrina	1
ALIAT	Ahmed Yassine	1
ALIAT	Mohammed	1
ALIK	Fatma Ines	1
ALIOUANE	Ikram Lina	1
ALLALOU	Randa	1
ALOUACHE	Nada	1
AMAR	Mohamed Amine	1
AMIR	Faical	1
AMMOUR	Abderrahmane	1
AMRANE	Hiba Ibtissem	1
AMRANI	Amira	1
ANSEUR	Selsabil	1
AOUANOUK	Ahcene Zakaria	1
ARAB	Yacine	1
AYACHI	Rameh	1
AZIL	Chiraz	1
AZRARAK	Chahinez	1
AZZOUZI	Ali Salah Eddine	1
BABA AISSA	Djamil	1
BABAALI	Mohamed Aymen	2
BAHBOU	Dalia Lylia	2
BAHLOUL	Aymen	2
BAHLOULI	Mohamed	2
BAHTOUNE	Miled	2
BALAMANE	Soheib	2
BALEH	Hocine	2
BALI	Mohamed Nazim	2
BARBARI	Abderrahim	2
BARBERIS	Roufeida	2
BARKA	Hadjer	2
BECH	HIBAT ERRAHMANE	2
BEDAIDA	Rayane Messaoud	2
BEDKA	Mohamed	2
BEKHOUCHE	Amine Mohamed	2
BEKRAR	Lazher Amir El Islam	2
BELAID	Celina	2
BELALIAT	Mounsef	2
BELARBI	Nazim	2
BELBACHIR	Amina	2
BELGUENBOUR	Tarek	2
BELHOUT	Nouria	2
BELKACEM	Yasmine	2
BELKACEMI	Norhane	2
BELKHADRIA	Sohaib	2
BELKHIRI	Meriem	2
BELLHADJ	Ines	2
BELLOUT	Hilwa	2
BEN MOMENE	Mieriem	2
BENABDERRAHMANE	Ibtihal Sahar	2
BENACER	Mohamed	2
BENACHOUR	Rayan Soheib	2
BENAMIROUCHE	Rania	2
BENAMRA	Fatima Zahra	2
BENANE	Chafik	2
BENARIB	Ines	2
BENBARA	Rostom	2
BENCHERIF	Youssra	3
BENDOUMIA	Hind	3
BENGHEZAL	Feriel	3
BENHALIMA	Sara Nadjet	3
BENKHALED	Asmaa	3
BENLAREDJ	Khadedja	3
BENLOUNES	Yasmine	3
BENMAHDJOUBA	Naouel	3
BENOUALI	Haoua	3
BENSALAH	Baha Eddine	3
BENTOUNSI	Salima	3
BENYOUCEF	Ibrahim El Khalil	3
BENZAOUI	Ahmed Yassine	3
BENZAMIA	Nada	3
BENZEMMOURI	Meriem Batoul	3
BERKATI	Zinedine	3
BERRA	Djouiaria	3
BERRAZZEG	Abderrahmane	3
BEY	Younes Aymen	3
BOUACHE	Sidali	3
BOUADI	Nedjma	3
BOUADJADJA	Rafik	3
BOUAFIA	Kaoutar Yousra	3
BOUAKEUR	Samy	3
BOUAKOUK	Nadjet	3
BOUALI	Manar	3
BOUALI	Rayan	3
BOUALI	Younes Abderrahmane	3
BOUATTOURA	Selsabil	3
BOUBEGUIRA	Mohammed Anis	3
BOUBEKER	Ines	3
BOUCHAITA	Sirine	3
BOUCHAMA	Nourane	3
BOUCHEMAL	Mohamed Adlane	3
BOUDA	Nawel	3
BOUDINAR	Massilva	3
BOUDJA	Aya	3
BOUDJEMIA	Ines	3
BOUDRALI	Djihane	3
BOUGHATANE	Zakaria	3
BOUGHERBAL	Besmala	3
BOUGUERNI	Yacine	3
BOUKADOUM	Mohamed	3
BOUKERCHE	Rahil	4
BOUKERRAM	Yanis	4
BOUKHALFA	Lamia	4
BOUKHEDIMI	Dyna Soroure	4
BOULABBA	Inel Dhia Eddine	4
BOULEROUAH	Redouane	4
BOUMEDJADJI	Mohammed Salah Eddine	4
BOURAS	Manar	4
BOURAY	Raihana Hiba	4
BOUREGA	Abderrahmane	4
BOUSBA	Mouad	4
BOUSEDER	Riadh Hocine	4
BOUSSAHA	Abid	4
BOUTAIBA	Lylia	4
BOUTATA	Sarah	4
BOUTELDJA	Romaissa	4
BOUTRIG	Nihad Yousra	4
BOUZEGZA	Mohamed Rayan	4
BOUZIDI	Islem	4
BOUZIDI	Mohamed Abderrahmane	4
BRAHMIA	Aymen	4
BRIK	Lamis	4
CHAHBOUB	Younes	4
CHELALI	Sofia Khadidja	4
CHEMLAL	Mohammed	4
CHERFAOUI	Massinissa	4
CHERIFI	Yasmine	4
CHIBANE	Chahrazed	4
CHOUMANE	Anefal	4
DAHMANI	Lydia	4
DALI BRAHAM	Mohamed Amine	4
DAMECHE	Hamza Samy	4
DJABALI	Fares	4
DJAFER CHERIF	Tarek	4
DJAKHDJAKHA	Imen	4
DJANATI	Chaima	4
DJEDDOU	Moncef	5
DJELLAL	Yasmine Meriem	5
DJELTI	Aicha Basma	5
DJEMAA	Raihana Hala	5
DJERADA	Meriem	5
DJERMOUNE	Ferial Nour Elhouda	5
DJERROUD	Yanis	5
DJIOUA	Siham	5
DJOUADI	Asma	5
DJOUADI	Lyna	5
DJOUHRI	Elyes	5
DOULI	Amira	5
DRIOUCHE	Ayoub	5
ELABANI	Nada	5
ELBACHIR	Zoulikha Farah	5
FATAH	Ahlam	5
FERHAT	Abdelkrim Nabil	5
FERNANE	Mourad Islam	5
FERRAD	Wassim	5
FIALA	Ahmed Yassine	5
FILALI	Abd Echafi	5
FOUDI	Haithem Nizar	5
GADOUM	Ines Yasmine	5
GANA	Ahmed Taki Eddine	5
GARI	Karim	5
GAYA	Mehdi	5
GHAZI	Cerine	5
GHAZI	Manar	5
GHAZIOUI	Nadine	5
GHEMARI	Yousra	5
GHERBI	Ahlam	5
GHERBI	Fatma Inass	5
GHERZI	Akrem	5
GHESSAS	Manel Lyna	5
GHORAB	Oualid	5
GRINE	Nardjes	6
GUERDA	Walid	6
GUERFI	Rahma	6
GUERMAH	Mahdi	6
HABBOUCHE	Anes	6
HACHIM	Salim	6
HADDAD	Sid Ali	6
HADDADOU	Meriem Yasmine	6
HADDAR	Aghiles	6
HADJ MEBAREK	Aya	6
HADJADJ	Mohamed Baha Eddine	6
HADJAOUI	Islam Abdelkrim	6
HAFRAOUI	Amal	6
HAFSI	ABD EL ADHIM	6
HALIT	Salima	6
HAMADACHE	Youssouf	6
HAMADOU	Aicha	6
HAMADOU	Maria	6
HAMDANE	Sarah	6
HAMIMED	Islem	6
HAMMADA	Abdelmalek	6
HAMMADI	Nesrine	6
HAMMAMOUCHE	Maya Cerine	6
HANI	Moussa	6
HASSAINE	Ahmed	6
HATTAB	Ayoub	6
HEDROUG	Nour Elislam	6
HIMEUR	Yahia Anis	6
HITEM	Samir El Hassen	6
IOUSSAIDENE	Chahinez	6
KADA	Besma	6
KAHLAT	Salim	6
KAOUANE	Ahmed	6
KEBIR	Ibtihal	6
KERBOUAI	Hamza	6
KERDJIDJ	Amine	6
KERDOUH	Farah	6
KERMOUCHE	Aya Yasmine	7
KESSOURI	Lyna	7
KETTAB	Fares	7
KHALED	Aymene	7
KHAROUBI	Abdennour	7
KHIAL	Ibrahim	7
KHODJA	M'Hand Fassih	7
KISSI	Abdelkader	7
KOUADI	Merouane	7
KOUDRI	Lamia	7
LABATCHA	Amina	7
LABED	Zine Ddine	7
LAGRAA	Houda Maria	7
LAHBIB	Kaouther	7
LAHMIRA	Israa	7
LAHOUASSA	Bouthaina	7
LAKLI	Safa	7
LAMRAOUI	Sirine	7
LAOUMIR	Lakhdar Abdelhassib	7
LARABI	Mohamed Soufiane	7
LARROUM	Nada Thana	7
LATRECHE	Abderraouf	7
LEBDIRI	Ouaisse	7
LEBEZ	Ousseyd	7
LEKHAL	Walid	7
LOUAKED	Said Othmane	7
LOUHAB	Nada	7
MAATI	Aicha Zahira	7
MABREK	Ishak Abdelhak	7
MAHDID	Oualid	7
MAHFOUF	Ania	7
MAHROUM	Amayes	7
MAIDI	Israe	7
MALKI	Nihel	7
MANARI	Malak	7
MASKRI	Hamza	7
MAZA	Tinhinane	7
MEBARKI	Thiziri	7
MEBRAK	Kenda	7
MECHOUREB	Islam	8
MEDBAL	Tinhinane	8
MEDDOUR	Amel Anais	8
MEDIANI	Wacim	8
MEDJAHED	Feriel	8
MEDJMADJ	Liliane	8
MEFTAHI	Zakaria	8
MEGUELLATI	Moncef Abdeldjalil	8
MEKHOUKH	Anes	8
MEKKI	Anis	8
MELAIS	Yahia	8
MENAS	Issam	8
MENZER	Mohamed Ilyes	8
MERAIHIA	Wail	8
MERHOUNI	Meryem	8
MERIDED	Chahrazed	8
MERNIZ	Sarra	8
MERSAOUI	Mohamed Imad Eddine	8
MESSARA	Melinia	8
MESSELLEKA	Souhaib Abdellah	8
MESLEM	Ayyoub Abdelaali	8
METTARI	Fethi	8
MEZGHRANE	Roumaissa	8
MIHOUBI	Yanis	8
MILAZ	Liza	8
MIMANE	Lylia Mokhtaria Nesrine	8
MOHAMMEDI	Zineddine	8
MOHELLEBI	Abdallah	8
MOKADEM	Hadjer	8
MOKRANI	Mohamed Tahar	8
MORSLI	Mohamed Abdennour	8
MOUAZ	Sidahmed Alae Din	8
MOUHEB	Hana	8
MOUHOUB	Cerine Ferdous	8
MOULAY	Mohamed El Touhami Abdeldjallil	8
MOUSSAOUI	Aya	8
MOUSSAOUI	Thileli	8
MOUSSOUM	Soulef	8
NAHI	Ahcene	9
NAIT SAIDI	Mohamed Akram	9
NASRI	Mounir Yacine	9
NETTOUR	Nedjem Eddine	9
NIA	Rayan	9
NOURI	Houdaifa Nadjem Eddine	9
OTMANI	Mohamed	9
OUADI	Anfal	9
OUAHAB	Assia	9
OUAKKOUCHE	Yacine	9
OUALI	Anais	9
OULD HAMOUDA	Mohamed	9
RACHEDI	Abderazak	9
RADJATI	Mouad	9
RAHIL	Tarek Abderraouf	9
RAHMOUNE	Rayan	9
REKHIL	Aya	9
REMADHNIA	Ibtihel Maissa	9
REZIOUAK	Moad	9
REZKELLAH	Ilyes	9
REZOUG	Fares	9
ROUABA	Chaimaa	9
ROUAG	Takie Eddine	9
SAADI	Dhoha	9
SABEUR	Nour El Houda	9
SADAOUI	Rym Ines	9
SAHKI	Lydia	9
SAIB	Mohamed Djawad Eddine	9
SAIDANI	Abderrahmane	9
SAIDANI	Aymen	9
SAIGHI	Ali Imad Eddine	9
SALEMI	Dahlia Sarah	9
SALEMKOUR	Leila	9
SALMI	Mounira Yasmine	9
SATOR	Manel	9
SEGHIRI	Enfal	10
SEKHRI	Tiziri	10
SELLOUMI	Alicia	10
SEMROUNI	Adam	10
SENOUCI	Walid	10
SI BELKACEM	Yahia	10
SILMI	Meriem	10
SLIMANI	Abdallah	10
SMAIL	Riadh	10
SOUAKRI	Thabet	10
TAALBI	Nadjib	10
TAIBI	Aimen	10
TAIEB	Mohand Ameziane	10
TAIEB ERRAHMANI	Mohamed Djihad	10
TALBI	Anis	10
TARI	Abdelkader	10
TCHIKOU	Abdelhak	10
TEIBI	Cerine	10
TIDJANI	Nadir	10
TITRAOUI	Fadi	10
TOUKAL	Wissam	10
TOUMI	Roufaida	10
TOUNSI	Yanis	10
YAHI	Sara	10
YAICI	Ines	10
YASSA	Kamilia	10
YOUNES	Idris	10
YOUNSI	Assia	10
ZAABAT	Hasna	10
ZAIR	Ines	10
ZAOUADI	Yassine	10
ZEGHAD	Anwar	10
ZEMOUR	Abderaouf	10
ZIBRA	Hibat Errahmane	10
ZIDANE	Yanis	10
ZITOUNE	Ahmed Yacine	10